(that) means == nan mái > (นั่น)หมาย
accident == ooba(t)eehed - อุบัติเหตุ
admire == chom > ชม
afternoon == ton yen - ตอนบ่าย
afterwards == payláng > ภายหลัง
ago == gawn (  minutes ago, ha nati gawn) 
air == ahgahd > อากาศ
airplane == krung been > เครื่องบิน
allergic == péhh > แพ้
almost == clai 
alone == kon neeyo > คนเดียว
already == leyo 
also == dooay > ด้วย
angry == glod - โกรธ
animal == sa(t) - สัตว์
annoyed == rankan - รำคาญ
ant == mot
are == (p)en > เป็น
are you sure? == khun nai czai mai - คุณแน่ใจไหม?
arm == kén > แขน
attitude == ta tee - ท่าที
australia == australia > ออสเตรเลีย
baby (human) == taro(g) > ทารก
bad == mai dee
balance == somdon - สมดุล
be better == dee gwa - ดีกว่า 
be careful == rawang > ระวัง
bean == tuwa > ถั่ว
because == praw - เพราะ
begin == rerm - เริ่ม
beginner == poo rerm > ผู้เริ่ม
believe == cheu-a - เชื่อ
better == deegwa > ดีกว่า
betting == deng pang > เดิมพัน
big == yay - ใหญ่
bird == nó(k) > นก
bite == kad (no air k) - กัด
black == dam - ดำ
blanket == paahawm - ผ้าห่ม
blood == luyad - เลือด
blue == see namon - สีน้ำเงิน
boat == re (like hot in chinese) > เรือ
boiled egg == kai tom > ไข่ต้ม
book == nan sú > หนังสือ
both == tang sóng - ทั้งสอง
brain == somóng > สมอง
bread == khanon (p)ang > ขนมปัง
break composure (muay thai term) == seeya - เสีย
breasts == na og - หน้าอก
breathe == hai czai - หายใจ
bright (light) == sod sái > สดใส
broken == dehhg (silent g) - แตก
broom == mai kwad - ไม้กวาด
brown == see nam(t)an > สีน้ำตาล
brush teeth == praeng fan - แปรงฟัน
but == (t)ehh - แต่
butt == chon - ชน
buy == su(g) - ซื้อ
call == ton > โทร
calm == neeyeb - เงียบ
can == tamdai - ทำได้
can you? == dai mai - ได้ไม่
car == rokyon - รถยนต์
carrot == carro(d) > แครอท
carry == pog pah > พกพา
chair == gao ee > เก้าอี้
change == (p)leng (p)leiing > เปลี่ยนแปลง
chili == met pree(g) == พริก
china == cheen > จีน
city == muh-ung > เมือง
class == chán > ชั้น
clean == sayad - สะอาด
close by == glay glaii > ใกล้ ๆ
clothes == suhh paa > เสื้อผ้า
coding == gan kaorahad > การเข้ารหัส
cold (i feel cold) == naow - หนาว
cold (water) == yen - เย็น
come here == ma ni 
come on == ma
come with me == ma kab chan - มากับฉัน
comfortable == sadug sabai - สะดวกสบาย
complain == bon - บ่น
concentrate == (t)ang somatee > ตั้งสมาธิ
confused == sabsón - สับสน
consistent == kong sen kong waa > คงเส้นคงวา
cook (verb) == prung ahan - ปรุงอาหาร
corn == kaowpo(d) > ข้าวโพด
crazy == ba - บ้า
cry == rong hai - ร้องไห้
cucumber == dteng gua > แตงกวา
cuddle == god - กอด
curious == yagru ya hén - อยากรู้อยากเห็น
cute == na (high a) rag - น่ารัก
dance == dem ram  - เต้นรำ
day == wan - วัน
dessert/candy == kanom - ขนม
determined == nei non > แน่นอน
dick == kuay
different == dang - ต่าง
dirt == foon > ฝุ่น
dirty == sogabrog - สกปรก
disappointed == peedwang - ผิดหวัง
diving == gan dan nam > การดำน้ำ
dizzy == wingweeyen > วิงเวียน
door == pratu (t has tono air)
dress == (t)en(t)ooa > แต่งตัว
drive == kab - ขับรถ
easy == ngayy - ง่าย
eat first == gin gone > กินก่อน
elbow == kaosog (silent g) 
energy == palang (พลัง) or ren
english language == kasa angree > ภาษาอังกฤษ
enjoy == senug - สนุก
europe == euro > ยุโรป
every time == tug wela > ทุกเวลา
everyday == tuk wan - ทุกวัน
excited == (t)ern (t)en - ตื่นเต้น
excuse me == tod dee ka (south thailand) kau tod ka
expensive == pong > เเพง
experienced == mee (p)rasogaan > มีประสบการณ์
explore == samrua(c) - สำรวจ
eye == ta (t has no air)
family == krob krua > ครอบครัว
fan == palom
far == pang glai > ห่างไกล
fart == pie lom - ผายลม 
fast == reio - เร็ว
fat == ooan - อ้วน
father == paw > พ่อ
feather == kén - ขน
feed (the chicken) == lee-uhn (gai) - เลี้ยงไก่
feel == rusug - ฉันรู้สึก
feel better == dee kuhn - ดีขึ้น
ferry == reux kam pha(g) > เรือข้ามฟาก
fight == soo - สู้
finger == niew
flashcards == ba(t) kam sa(p) > บัตรคำศัพท์
flower == do(g) mai - ดอกไม้
fly == been - บิน
foot == tao 
for example == (t)aw yang chen > ตัวอย่างเช่น
for sure == nei non > แน่นอน
fork == sawm - ส้อม
fresh == sod > สด
fruit == po lamai > ผลไม้
fun == senug > สนุก
funny == talog - ตลก
gas == ga(s) - ก๊าซ
gloves (boxing) == nuom - นวม 
good == dee
good morning == swadee ton chaow ka > สวัสดีตอนเช้าค่ะ
great == mahá > มหา
green == keeyo - เขียว
gross (food) == khan (t)on > ขั้นต้น
habit == nee sai - นิสัย
hair == pom
half == klung > ครึ่ง
hand == meuu 
handwrap == pa pan > ผ้าพัน
hang (clothes) == kwen suh pa > แขวนเสื้อผ้า
happy == mi kwam suk - มีความสุข
hard == ya(g) - ยาก
head == húa > หัว
healthy == keng ren > แข็งแรง
hear == daiyeen - ได้ยิน
heart == pwa zhai > หัวใจ
heavy == gnag- หนัก
help == chuay - ช่วย
here == teenee > ที่นี่
hip == sapo(g) - สะโพก
home == ban - บ้าน
hospital == rong payaban > โรงพยาบาล
hour == chawmong - ชั่วโมง
how == nai yang rai > ได้อย่างไร
how did you do that? == khun tamdai yang rai? - คุณทำได้อย่างไร?
how do you feel? == khun rusug yang rai - คุณรู้สึกอย่างไร
how do you know? == khun ru nai yang rai > คุณรู้ได้อย่างไร
how do you pronounce == khun og seeyang yangrai > คุณออกเสียงอย่างไร
how do you say in thai? == khun pood thai yai yang rai? > คุณพูดไทยได้อย่างไร
how long? == nan kai nai? > นานแค่ไหน
how much is it? == raka kaow rai? > ราคาเท่าไหร่?
hug == ragon - ตระกอง (can also be กอด - god)
hurt == czeb - เจ็บ
i am interested == chan son czai > ฉันสนใจ
i don’t care == chan mai son jzai > ฉันไม่สนใจ
i feel hot == chan rusug ron - ฉันรู้สึกร้อน
i like == chan chob > ฉันชอบ
i think == chan keed > ฉันคิด
i want to see == chan tongan yag hén - ฉันต้องการอยากเห็น
ice == nam ken - น้ำแข็ง
idea == kwam keed - ความคิด
if == (t)aa - ถ้า
inside == pai nai - ภายใน
interesting == na song chai - น่าสนใจ
itchy == kan - คัน
i’ll be back == cha jza glab ma > ฉันจะกลับมา
job == gnan > งาน
joking == kam kán > ขำขัน
keys == khun zhae 
knee == kaow 
language == pasá > ภาษา
laugh == wo rao - หัวเราะ
leaf == bai mái > ใบไม้
learn == rii-en - เรียน
left == sái == ซ้าย
left kick == (how the announcers say) - tai (no air t) sai 
leg == kaa
less == noy - น้อย
long (time) == (wela) nan > (เวลา) นาน
long == yaow - ยาว
long time == wela nan > เวลานาน
look for == muong há - มองหา
lose == pehh - แพ้
loud == (da)ang - ดัง
make == tam - ทำ
market == talat
maybe == a cza > อาจจะ
memorize == jzod jzam > จดจำ
memory == kwam cham
minute == natee - นาที
mistake == péed plaad > ผิดพลาด
month == deyern - เดือน
more == magwa - มากกว่า
mosquito == yung -  ยุง
mouth == pag (silent g) 
muay thai fight == doi muay
muscle == glam nu-úh > กล้ามเนื้อ
music == pleng - เพลง
my back == lang kong chan > หลังของฉัน
neck == kaw - คอ
need == tongkan - ต้องการ
negative (attitude) == (tasanakadee) chung lob > ทัศนคติเชิงลบ
nevermind == mai pen rai > ไม่เป็นไร
new == mai (down accent) - ใหม่
news == khao - news
next time == krang na - ครั้งหน้า
no problem == mee mi (p)on háa > ไม่มีปัญหา
noodles == gway deeyo > ก๋วยเตี๋ยว
normal == bogatee - ปกติ
nose == chamug - จมูก
not like you == mi muong khun > ไม่เหมือนคุณ
old == gao - เก่า
or == reux > หรือ
our == kong raow
pay == czai reng > จ่ายเงิน
pee == chee - ฉี่
phonecall == sai kaow > สายเข้า
pillow == món
plate == czan - จาน
play (video games) == len - เล่น
poop == kee
potato == manfarang > มันฝรั่ง
price == raka > ราคา
protection == (b)ongkan - ป้องกัน
proud == pume chai - ภูมิใจ 
punch == mad - หมัด
puppy == lu(g) suna(g) > ลูกสุนัข
put == sai - ใส่
question == kam (t)ám - คำถาม
quickly == yang rude reio > อย่างรวดเร็ว
quiet == neeyeb - เงียบ
rain == fon (up accent, short)
read == an - อ่าน
ready == prawm leyo - พร้อมแล้ว
red == see deng - สีแดง
relationship == kwam sampan - ความสัมพันธ์
remember == czam - จำ
rent == pei chaow > ให้เช่า
respect == kaoró > เคารพ
return == glab > กลับ
right == kwá - ขวา
right now == ton nee
sad == cié czai - เสียใจ
same == muong gan - เหมือนกัน 
save (food) == ban tuhhg > บันทึก
scared == glua - กลัว
school == rong reeyen > โรงเรียน
scratch == gaow - เกา
seafood == ahan talei > อาหารทะเล
second == ti song - ที่สอง
see == doo - ดู
sell == káy - ขาย
separate == yaii(g) > แยก
share == huune > หุ้น
shin == na keing > หน้าแข้ง
shirt == suhh-a - เสื้อ
shoe == ron tao - รองเท้า
short == san - สั้น
shorts == kang geing - กางเกง
shrimp == gung > กุ้ง
sick == puay
sing == rong pleing - ร้องเพลง
sky == tong fa - ท้องฟ้า
sleep == non - นอน
sleepy == won non
slow == cha - ช้า
small == leg (silent g) - เล็ก
smell == gleem > กลิ่น
smell bad == min
smell good == hom
smile == yím - ยิ้ม
smoke == kwan - ควัน
sometimes == bangkráng > บางครั้ง
sound == seeyang > เสียง
spring roll == po pia - ปอเปี๊ยะ 
start == rerm ton - เริ่มต้น
stay == pag yuu > พักอยู่
still == yang
stomach == krapow ahan
store == gheb - เก็บ
stress == kriyeg - เครียด
stretch == yeuxd > ยืด
strong == ken reng > แข็งแรง
study == sug sá > ศึกษา
stupid == gno - โง่
suck == dude - ดูด
sun == dong ateet > ดวงอาทิตย์
surfing == tong > ท่อง
sweaty == piag heu-a
table == dó > โต๊ะ
talk == gan pood kuyi > การพูดคุย
tall == sung - สูง
teeth == fan
tell me == bog chan > บอกฉัน
that is not good == tee mee dee > ที่ไม่ดี
that means something bad == nan mái (t)ung sing tee mee dee > นั่นหมายถึงสิ่งที่ไม่ดี
thirsty == krahay nam - กระหายน้ำ
throw == yone - โยน
throw away == ting - ทิ้ง
throw up == a jien - อาเจียน
tickle == chi > จี้
today == wan nee - ในวันนี้
together == dui gàn > ด้วยกัน
tomorrow == plung nee - พรุ่งนี้
tongue == léen
tonight == kune nee - คืนนี้
too (much) == (mag) gun (p)ai > (มา) กเกินไป
touch == (t)ai > แตะ
towel == pa chet doa - ผ้าเช็ดตัว
train hard == fug nag - ฝึกหนัก
training == gan fug had - การฝึกหัด
translate == (p)lehh - แปล
trash == kaya - ขยะ 
tree == (t)on mái > ต้นไม้
trust == wang jzai > วางใจ
try == long > ลอง
turn == glab - กลับ
turn off the light == peed fye - ปิดไฟ
turn on the light == ped fye - เปิดไฟ
underwear == chud chan nai > ชุดชั้นใน
university == (maha) (weetee) yalai > มหาวิทยาลัย
use == chai > ใช้
vegetables == pag - ผัก
wait == raw - รอ
walk == durn - เดิน
wash == lang
weak == on aiee > อ่อนแอ
weight == nam na(g) > น้ำหนัก
weird == pleeh(g) > แปลก
wet == peeyag (no air p) - เปียก 
what are you doing? == (khun gamlang) tam arai? > (คุณกำลัง)ทำอะไร?
what do you want? == khun tongkan arai? - คุณต้องการอะไร?
what does that mean == na mai kwam wa yangrai > นั่นหมายความว่าอย่างไร
what time is it? == wela gee mong - เวลากี่โมง
when == meux-ah? > เมื่อ?
white == kao - ขาว
why == kamay - ทำไม
win == chana - ชนะ
wind == lom > ลม
windy == lom ren > ลมแรง
with == gab - กับ
wood == mái > ไม้
word == kahm - คำ
work hard == tamyan gnag > ทำงานหนัก
working == taman
write == keeyen - เขียน
year == (p)i > ปี
yell == tagawn - ตะโกน
yellow == see luh-úng > สีเหลือง
you == khun - คุณ
you are correct == khun tug - คุณถูก
you are early == khun pen khun rei(g) > คุณเป็นคนแรก
you are late == khun ma saí > คุณมาสาย
you are nice == khun czai dee -  ดคุณใจดี
you are wrong == khun peed - คุณผิด
young girl ( and younger) == deg sao -  เด็กสาว
young woman ( to ) == nume sao - หนุ่มสาว
you’re welcome == gindee donrap khun > ยินดีต้อนรับคุณ
